cta.PNG	"CorgiTheftAuto"	14.99	"Ya'll ever just stop a random car, pull out the driver and demand they give you a belly rub??? Because saaaame"
pro_wall_puncher.PNG	"Kyle Smith's Pro Wall-Puncher"	14.99	"Special stepdad fught DLC coming soon!"
hidden_valley_white_claw.PNG	"Hidden Valley White Claw"	7.99	"Yo, is this even legal???"
skate_4.PNG	"Skate 4"	15.99	"Bout to hit a 360 double nuke on ya a** us"
pro_snicher.PNG "Pro Snitcher"	14.99	"Ya know damn well you would do the same to get 20+ years off your sentence"
30_yr_old_boomer.PNG	"The 30 Year-Old Boomer"	13.99	"If you need a friend, someone to vent to, or any advice dm me"
yodirt.PNG	"Yodirt"	7.99	"Need this, you do."
mullet_combat.PNG	"Mullet Kombat"	12.99	"Ass kicking in the front, party in the back"
home_malone.PNG	"Home Malone"	8.99	"Hold tf up"
kany_simulator_20.PNG	"Kanye Simulator 20"	19.99	"Description"
rob_lowe_tailgate.PNG	"Rob Lowe's Tailgater 2"	15.99	"GO TEAMS!"
were_out.PNG	"We're Out"	12.99	"Jordan Peele's newest scary movie"
monster_toothpaste.PNG	"Monster Energy Toothpaste"	3.74	"Bleeding gums during use is normal. Do not be alarmed."
march_madness.PNG	"March Sadness"	13.99	"Description"
thats_so_beans.PNG	"That's So Beans"	12.99	"I too am so beans"
gta_philly.PNG	"Grand Theft Auto Philadelphia"	15.99	"Description"
lil_john_silvers.PNG	"Lil John Silver's"	34.99	"Til the sauce drip down my jaw, all these fishes craw"
heinz_ketchup_soda.PNG	"Heinz Ketchup Soda"	3.74	"This can be found literally everywhere in Canada"
corona_virus.PNG	"Corona Virus"	7.99	"You can really taste the untimely death"	
scott_1000.PNG	"Scott 100"	2.99	"Soft, but in a good way..."
purell_ham_san.PNG	"Purell Ham Sanitizer"	17.99	"Call us out for price gouging, we'll deny it!"
trangs.PNG	"The Best Shape is Triangle"	5.99	"The Bermuda Triangle"


